"","x"
"1"," ﻿KOťNÍK IV.


TŘÍDA II.


ČÍSLO 10.


vrozené slabosti její komplikacích.


Napsal I)r. Rudolf Kimla, assistcnt ústavu.


ústavu patholoyicko-anatomického prof. Ura. Jaroslava Hlavy. (SdOlení ÍMj.)


Předloženo dne 15. března 1895.


Všeobecně známou jest značná úmrtnost novorozených prvních nedělích městcích života. Dle statistiky Wappfiusovy*) milí. všech úmrtí připadá úmrtí dětských prvém roce života 2557%, porodil pak mrtvých dětí 4'75%; úhrnný počet tudíž činí oO32%. Ofňcielní statistika Francie 18(U—(>5 ukazuje počet úmrtí dětí prvém roce života kolísající mezi l(5-r>2%, letech ISTO—77 mezi 14—30%. Dle Hcmicha*) úmrtnost dětí největší jest prvých týdnech měsících, prvním roce pak jest více než dvojnásobná roku následujícího, načež teprve druhém roce mírně klesá roce pátém ukazuje obyčejný poměr. prvém roce jednoho tisíce novorozených zmírá asi pětina, kdežto povšechná úmrtnost obyvatelstva jeví poměr 25:l()rO. těchto úmrtí připadá zase značné percento úmrtí prvních dnech nedělích post partům. Příčiny toho jsou bíledni. porodu dítě vstupuje podmínky životní nové, mnohem nepříznivější; místě oběhu foetahiího výměnu látek přejímá traktus respirační zažívací dosud nečinný porodu dosud neúplně zařízený, neboť plíce stavu atelektasy přicházejí stavu vzdušnosti tkáně, nich lenivý oběh stává čilým významným, traktu zažívacím pak soustava žlazek slizničních neúplná teprve průběhu dalších dnu doplňuje, soustava pletení mízních střevě foetu neobyčejně vyvitá naopak redukuje míru náležitou.''') Mimo novorozeném dokonávají se, nehledě čilému vzrůstu rozvoji povšechnému, ještě další pochody fysiologické, jako jest uzavření průchodů embryonálních srdci cévstvu, rozvoj hemisfér mozkových, ossifikace, dentice. Jest tudíž srozumitelno, proč organismus mladistvý, mnoha příčinách dosud nedokonalý, snadno podléhá mnohonásobným vlivům


f,V/7/,i/-,// Hdb. der Kindcrkrankheiten 5iW.


Jlenoch Vorlesungen uber die Kinderkrankheiten, Aufl., Berlin ISiXX, •') tiaginsky: Untersuchungen uber den Darmkanal děs menschlichen Kindes. Virch. Arch. Bd. 8!).


Koz pra vy. Ročník IV. Třída II.


﻿okolí, tím snáze, čím nepříznivější osud pozdraví děcko hned kolébky. Tím smutnější prognosa ovšem jeví dítek stižených vrozenou slabostí, dítek, jež abychom užili slov prof. Schwinga přicházejí svět, nejsouce opatřeny náležitou výbavou životní. Dítky vrozeně slabé, jak známo, nemají ani náležitých rozměrů, ani váhy přiměřené, jeví povšechnou hypoplasii. Obličej jejich často mívá výraz stařecký, kůže jeví kolorit šedožlutavý; respiracc jest povrchní, extremních částech těla patrný jest cyanotický nádech. Děcko pohybuje lenivě, jest apathickým, nekřičí jen žalostně kvílí, nebere prsu matčina. Temperatura přes umělé zahřívání bývá snížena. Dítě chřadne, víc více ubývá váze, tempcratura jeho klesá, načež zmírá. dítek vrozeně slabých jen nepatrný počet vlivem nejpečlivějšího nejpřiměřenějšího ošetřování zachrání, ostatní zmírají, bud' záhy porodu, neb krátkém čase později, tom případě většinou následkem rozmanitých chorob druhotných. Při autopsiích přesně dají rozeznati případy, nichž smrt nastala následkem slabosti vrozené samé, případů, kde druhotnými chorobami, většině rázu infekčního, exitus byl způsoben.


případu prvém nález anatomický jest chudičký. Jsou děcka umírající záhy porodu kollapsu následkem slabosti srdeční progressivně přibývající provázené často konvulsemi (llenoch). Substrátem pitevním bývá atelektasa plic, hlavně lalocích dolních lokalisovaná, často značně rozsáhlá, dále povšechné městnání krve žilní, nejvýznačnější játrech slezině, jakož prstech extremit, venosní překrvení plen mozkových, hlavně venosních splavů polebicc, dosti zhusta pak oedem měkkých plen, výlevy intermeningealní. některých případů možno nalézti myokard patrně ochablý poddajný, hlavně komoře pravé, nejčastěji však srdci nedokážeme nijakých známek chorobných. Rovněž svalstvo dýchací, jakož vůbec ostatní svalstvo trupu končetin, bývá špatně vité, často bledé.


Příčina odumírání dětí vrozenou slabostí stižených bývá kladena právě nevyvinutost nedostatečnost orgánů hybných respirace cirkulace. Jest pravda, nalézáme tyto orgány zhusta špatně vyvité, ale mnoha případech nejsou stavu nic špatnějším, nežli dětí získanou atrofií druhotnou následkem chorob traktu gastro-intestinalního, nichž přece mnohé mnohé zotaví normám. Zdá se, nedostatečnost obojích funkcí dětí vro~ ženě slabých nutno spíše hledati nenáležitém vývinu příslušných center nervových nedokonalé innervaci orgánů hybných cirkulace respirace, jakož okolnosti, buňky organismu nejsou opatřeny vlastnostmi takovými, aby mohly další existenci vitální energii svoji náležitě platnosti přivésti, zkrátka, pravidelně fungovati. Jest jen ovšem pouhá theorie, jejíž podporu mimo výsledky pozorování hrubých projevů činnosti dotyčných orgánů, níže vylíčené, ničeho reelního uvésti není lze. Otázka tato dosud nedá tak snadno luštiti, jelikož fysiologická znalost centrálního nervstva hlavně této otázce důležitých center dýchacích cirkulačních není dosa-vade dostatečnou. Nicméně sledujíce způsob odumírání děcka vrozeně slabého nalézáme asi následující hrubé momenty: Pohyby respirační jsou velmi povrchní, hrudník nerozepíná míry, aby veškeré sklípky plicní byly učiněny


﻿přístupnými pro vzduch. Obyčejně pouze tkáň volných okrajů předních, tam kde pohyby steny hrudníku jsou ncjintensivnější, naplňuje vzduchem, zadní části laloků plicních, hlavně ty, jež leží při páteři vydutině paravertebralní, zůstávají atelektatickými, protože pohyby stěny hrudní jsou minimální, neb vůbec žádné. Atelektasa tkáně plicní, původu jakéhokoliv, způsobuje však městnání krve, toť faktum všeobecně známé uznané. Příčinou stase jest stlačení kapillár, jakož klikatý průběh jich stěnách mezisklípkových, stlačení tenkostěnných žilek plicních tkáni bezvzdušné. Mimo často měli jsme příležitost pozorovati kapiilárách, jež krvenky obsahovaly, okrsku atelektatickém zv. agglutínaci rudých tělisek, způsobenou nedostatečnou oxydací výměnou látek. Čím větší jest rozsah tkáně atelektatické, tím znač-něji městná krev, tím mohutnější překážka položena jest cestu proudu malého oběhu, tím větší větší práce ukládá svalstvu komory pravé. Je-li nepoměr mezi prací, kterou srdce pravé vykonati mělo, aby prohnalo krev venosní plícemi předsíně levé, mezi silou svalstva komory pravé značný, pak ovšem dle zákonů fysikalních krev komory pravé značném kvantum prouditi bude skrze ductus Botalli aorty, jelikož proud krevní nalézá menší odpor, nežli obou větvích tepny plicní, děje tím spíše, protože ductus Botalli leží podélné ose tepny plicní, tvoře její pokračování, kdežto obě větve plicní odstupují tepny pod pravým téměř úhlem. Pím způsobem aorty proudí stále ještě massa krve venosní, oběhu plicním pak určité jednotce času proběhne méně krve než bylo norma, čili rychlost oběhu malého jest značně menší. Následek toho jest, srdce levého proudí jednotce času mnohem méně krve okysličené než norma, nepoměr ten pak vyrovnati snaží přítokem krve venosní skrze ductus Botalli, snad skrze foramcn ovále krev prochází levé předsíně. této cirkulaci možno poznati značnou podobnost oběhem íbetalním, tedy jakousi persistenci íbetalního oběhu post partům. následek tohor arterielním systému snížení tense smíšená krev, malém oběhu pak zvýšení tense, venostasa nedostatečná oxýdace, pravé srdce pak stížené prací nemírnou, kterou ov:em tím méně jest zastati, čím nepříznivěji utvořeny jsou současně podmínky činnosti myokardu hlavně podmínky innervace. Klinicky skutečně pozorovati lze případech takových tím zrychlenější slabší puls, čím rozsáhlejší jest atelektasa (Gerhardt). Porušení cirkulace někdy dostupuje takové výše, příznaky jeho klinika svedou diagnose vrozené vady srdeční, jak tom jasně svědčí dva případy našem ústavu pitvané. Jest případ seznamu, jejž níže uvedeme, pocl 7»>. zaznamenaný, pak případ A., dečko (medělní, pitvané dne ISSti; obou klinická diagnosa zněla vadu srdeční vrozenou, obou pak mimo značnou atelektasu plic persistenci ductus Botalli, jakož venostasu povšechnou, jiných změn nebylo.


Pro správnost našeho výkladu svědčí též okolnost, dětí vrozeně debilních, těch, které správně doneseny byly, často nalezneme široký otevřený průchod Botallúv ještě více nedělích.


Čím vydatnější jsou pohyby respirační, tím méně atelektasy plicích, tím spíše možno nadíti se, funkce srdeční udrží dostatečné síle.


﻿Leč zde často přistupuje zase nepříznivý moment ten, totiž často bron-chioli ucpávají hlenem, někdy dosti vazkýni, jehož odstranění slabými respiračními pohyby děcka debilního bývá nesnadné. Mimo následkem časté komplikace bronchitidy nejen ložiska foetalní atelektasy nesnadno mizejí, nýbrž naopak ještě vznikají jiná jiná ložiska bezvzdušná ucpání prúdušinek sekretem.


Dále velice záhy přistupují jiné vážnější choroby druhotné, ktc-ré nalézají velmi příznivý terrain, decimují děti, které nepodlehly následkům vrozené slabosti samé.


Dovolujeme uvésti následujících řádcích přehled všech autopsií dětí vrozeně slabých, vykonaných ústavě pathol.-anatomickém 1S,S«> konce 1894. Případy ty, počtem 14íí, valnou většinou pocházejí kliniky prof. Schwinga, ostatní obou klinik porodnických prof. Pavlíka prof. Rubešky.


Jméno	Vek	Diagnosa klinická	Poznání pitevní


Mošnička Josef	li d.	D. Lues heredi-taria (?)	Pleuropncumonia scrofibrinosa lobo-rum infer. Tumor lienis. Perisplenitis fibrinosa. Atrophia univ. (Mikroskopicky bakteriologicky dokázány exsu-datu pleuralním plicním čisté pncumo-bacilly Frankel-Weichsclb., exsudatu pouzdru slcziny pneumobacilly bac. coli.J


Černá Anna	lid.	1). Omphalova-sculitis purulenta.	Apncumatosis pulm. lobor. infer. Vcno-stasis universalis praec. or^anor. abdo-minal. Omphalitis purulenta. (Strepto-kokky


'3. Zej valová Marie	21 d.	D. Gan^racna cu-tis dorsi. Atelectasis pulmonum.	Gan^raena cutis regione dorsali. Kol-pova<finitis catarrhalis. Atelectasis lo-borum infer. pulm. Scpsis. (Staphyl. pyog. aureus proteus Zenkeri.)


Pou pelová Antonie	18 d.	D. Cyanosis.	Atelectasis partis poster, lobi inf. pulm. utriusque. Knteritis follicularis. Dilata-tio ventriculor. prače, dcxtri. Vcnostasis universalis.


Čech František	lid.	I). c.	Pneumonia lobularis confluens lobor. inf praecipue dextri. Enteritis catarrhalis.


Kropáčková Anděla	r> n.	I), Infans prae-maturum. Absces-sus n^ione sa-crali.	Porencephalia lobi frontalis hemisphae-rae sin. Atelectasis lobor. infer. Hae-morrha^iae punctiformes ej>icardi. Cho-Icstasis hepatis. Tumor lienis. De^cnc-ratio parench. rcnum cum haemorrh. punctiformibus corticis. Abscessus re-gionis sacralis. Icterus levis. Sepsis.


			


﻿Jméno	Včk	Diagnosa klinická	Poznání pitevní


Waworová Marta	l!í d.	O. Atelectasis pulmonum.	Pneumonia part. post. lobi sup. infcr. láteř, dextri. Abscessus apicis dextri. Tumor lienis follicularis. Dc^eneratio parench. hepatis renum. hlízy plic-ní vypčstován: Streptokokkus pyog. sarcina lutca bac. coli.)


Girgcl Josef	1!) d.	D. Atelectasis pulmonum.	Bronchopneumonia lobor. inferiorum. Enccphalomalacia nconatorum.


1). Pavlíková Maric	1 d.	I), Infans prac-maturum.	Atelectasis pulm. IIaemorrha<^iac inter-mcnin<;eales. Hypcraemia or^anorum.


10. Kadlecová Maric	i)d.	D. Icterus. Sclc-remacutis. Luesif j	Atelectasis pulm. lobor. infer. Endarte-ritis proliferans umbilici. Icterus. Lucs hercditaria.


Tlollmanová Barbora	l3/, m.	D. Atelectasis pulm.	Atelectasis lobor. infcr. bilateralis. Hae-morrha^iac punctiformes pleurac cpi-cardi.


1:2. Hyrnyšal Josef	Sd.	D. Atelectasis pulm.	Atelectasis lobi infcr. pulm. utriusque. Vcnostasis.


i:>. Pospíšil Jaroslav	I9d	D. Atelectasis pulm.	Atelectasis enormis pulm. praec. lobor. inf. Soor oris. Entcritis catarrhalis. Vcnostasis or^anorum. povlaku jazyka vlákna kokky. Kultura: typická mo-nilia.) Vyšetřil Honí.


Gcsswcin Karel	17d.	D. Trismus.	Sepsis omphalitidc purulcnta. Atrophia universalis. (Stofyl. aureus slc-ziny. Vyšetřil Honí.


l.r). Markytanová Anna	i<; d.	O. Atelectasis pulm. Knteritis.	Atelectasis pulm. Tumor lienis. Gastro-entcritis acuta. Degeneratio parench. hepatis. Hacmorrha^iae serosarum. Icterus. Sepsis


U!. Sečká Ludmila	17 d.	D. Sclerema cu-tis. Decubitus pc-dis dextri.	Pneumonia lobul. contlucns praec. lobor. infer. Sepsis omphalitide purulcnta. Dccubitus. Hvperaemia ven. or^anor.


17. Hhák Rudolf	L> d.	D. Atelect. pulm. Trismus.	Atelectasis pulm. Meningitis purulenta. Abscessus hepatis. Tumor licnis. Sepsis.


1H. Kalasová Maric	1 d.	D. c.	Atelectasis pulm. pacnc totalis. Hac-morrhaj^ia ventric. lateralcs ccrcbri.


lí>. Iladrl míčová Růžena	25 d.	O. Kntcritis. Atrophia.	Pneumonia lobularis conrluens lobor. inler. part. poster, lobor. super. Entcritis catarrhalis. Atrophia universalis.


'.20. Kocandová Maric	•1 d.	i), Sdcrema nconator.	Atelectasis pneumonia lobul. Icterus.


			


﻿Jméno	Věk	Diagnosa klinická	Poznání pitevní


iM. Vojtíšek Josef	r> d.	D. Sclerema neonator.	Apneumatosis part. poster, pulm. Vc-nostasis.


±2. Vaněk Ant.	1 m.	D. Atelcctasis pním. Knteritis ca-tarrh. acula.	Enteritis catarrhalis acuta. Atelcctasis pulm. Anaemia cerebri. Venostasis or-^anorum abdom. Atrophia universalis.


•J:>. Langová Al-l)ina	Id.	D. c.	Atelectasis lobi infer. pulm. utriusque. Venostasis organonům. Knteritis catarrhalis. Ictcrus levis.


•JI. Hronová Marie (dvojče)	!»d.	D. c.	Atelectasis pulm. lobor. infcr. Hyper-acmia mucosac ventriculi dtiodeni. Venostasis organor. abdom.


.!•"">. Žcnišek Kamil	10 d.	D. Gastroentc-ritis acuta.	Gastrocntcritis acuta. Pneumonia lobu-laris atelectases subpleurales, praec. pulm. sin. Ren un^uiformis.


•JI. Šenk Vojtčch	31 d.	D. Gastrocntc-ritis acuta. Atro-phia universalis.	Knteritis catarrhalis acuta. Apneumatosis pulm. partialis.


•JT. Mark;4rafová Marie	•_>-2 d.	D. c.	Pneumonia lobul. lobi inf. sin. conHuens, pulm. dextri dispersa. Atelcct. ba-sim lobi inf. dextri.


•Js. Noky Marie	11 d.	D. Sclerema. Atrophia univ.	Atelectasis lobor. inf. pulm. Venostasis. Atrophia univ.


LM.I. Hainiger Josef	L2d	D. Atelrct. ptilm. Knterilis acuta.	Pneumonia absccdens pulmonc. Atelectasis loborum irifcr. Knteritis acuta. (Ve hnisu hliz obsahu bronchů Gramem dokázány shluky kokků dvou. Neobyčejné množství mikrobů kokko-vitých čárkovitých hlrnu střevním mezi odchliplými hojnými epitheliemi. Stafylococcus aureus vyrostl kulturách. Vyšetřil Honí.)


:;«. IV! Václav	8n.	I), Atrophia ex-cessiva post entero-catarrhum.	Sepsis. Pneumonia purulenta lobi super, totius part. sup. lobi inf. pulm. dextri. Struma hyperplastica. Pharyn^itispseu-domembranacea. Knteritis catarrhalis. De^eneratio parenchymatosa or^ano-rum. Venostasis. (Streptococcus.)


:J1. Svárovská Marie	•2 m.	D. Pneum. lobul.	Atelectasis part. poster, lobor. omnium bronchitide diffusa. laemorrha^iae sul >pleurales. Venostasis. lironchopneu-monia partibus atelectat.


'•U. Viktora Rud.	1 m.	I), Knteritis fol-licul. acuta.	Gastrocnteritis acuta. Hypostasis pulm.


			


﻿Jméno	Vek	Diagnosa klinická	Poznání pitevní


33. Štčpanovský Alois (dvojče)	8d.	D. c.	Sepsis perivasculitidc purul. umbi-lici (Sreptococcus pyogenes). Plcuritis purulenta láteř, sin.metastatica. Hydro-ncphrosis rcnis sin. Infarctus acidurici. Atrophia univcrsalis.


34. Vclich Jaroslav	23 d.	D. Gastrocnter.	Pncumonia absccdens lobi sup. dextri. Enteritis catarrh. acuta.


35. Liezlcrová Antonie	2 m.	D. Gastrocnter.	Atclectases pulm. Errosines haemor-rhagicac mucosae duodcni. Gastroen-tcritis.


•;!<;. Sherks Rudolf	12 d.	D. Enteritis acuta. Apneumato-sis. Rhachitis. Atrophia univers.	Scpsis omphalitidc purulenta. Enteritis follicularis. Hypcraemia oedcma meningum haemorrhagiae interme-ningealcs. Pectus carinatum.


37. Bičišťová Emilie	15 d.	D. Infans prae-matur. Atrcsia va-ginao congluti-natione labiorum majorům.	H}rdroncphrosis bilatcralis praec. láteř, sin. Atrcsia vaginae urcthralis. Con-glutinatio lalMor. pudcndorum. Vagína septa. Uterus scptus. Atrophia univer-salis.


38. Sladovníková Božena	15 d.	D. Enteritis ca-tarrhalis acuta.	Scpsis post omphalitidem purul. Pneu-monia lobul. Enteritis.


30. Neuhaurová Marie	33 d.	D. Gastrocnteri-tis acuta. Pncumonia lobul. loborum infer. Decub. gangr. regionis ossis sacri. Sepsis.	Gastrocntcritis catarrh. Pncumonia lobul. lobor. infer. Decubitus gangr. reg. oss. sacri. Sepsis.


40. Navrátilová Maric	41 d.	D. Erysipelas capitis.	Erysipelas capitis colli. Tumor li-enis ač. Dcgcncr. parcnch. organorum. Scpsis.


41. Tichá Milada	3n.	D.c. Sclercma cutis.	Atelcctasis praec. pulm. sin. Catarrhus intcstinorum.


•12. Hájková Joh.	10 d.	D. c.	Atelcctasis pulm. Venostasis.


43. Růžička Hynek	1 m.	D. c.	Atelect. pulm. lobor. infer. part. poster. Venostasis.


44. Reilich Josef	?	D. Ictcrus.	Atrophia univcrsalis. Icterus.


45. Vcykrycht Josef	3 n.	D. let éru s.	Haemorrhagiae intermcningcalcs. Icterus.


1<5. Hansi Stanisl.	20 d.	D. c.	Degcneratio adiposa organorum.


			


﻿Jméno	Včk	Diagnosa klinická	Poznání pitevní


47. Novotný František	!in.	D. Icterus.	Pneum. lobul. part. post pulm. dextri. Atelectasis lobi infer. pulm. sin. Icterus. Venostasis. Atrophia.


18. Sýkora Otakar	M d.	O. Pneumonia in^estis. Icterus. Cyanosis.	Pneumonia lobul. conlluens lobor. infcr. lobi sup. lat. dextri. llcitis catar-rhalis. Tumor lienis aculus. Icterus ve-nostasis or^anorum.


l!». Ilolubovská Aloisie	4 n.	D. c.	Gastroenteritis acuta. Broncliopncum. dispersa lobor. omnium. Ilemorrha^ia subduralis supra hemisph. sin. totam. Haemorrhagiae punctíformo ]>leurac epicardi.


•"".< Sepekovská Anna	21 ti.	IX (dvojče).	Pneumonia lobularis lobi infer. dextri. Atc-lect. lobi inf. sin.


51. Pospíšil Václ.	4n.	D.c. (dvojče) Pneu-monki.	Pneumonia lobul. lobi inf. dextri. Venostasis.


5-J. Sepckovská Barbora	8 d.	D. c.	Icterus. Atrophia univcrsalis.


5:5. Hejlova Marie	1:5 d.	D. (Infans prac-maturum.j	Atrophia excessiva. (Partus praema-turus.)


51. Záruba Karel	Sn.	D.c.	Gastroenteritis acuta. Anaemia univcrsalis.


55. P.irchta Václ.	17 d.	D. Sclcrema cu-tis. Gastroenteritis.	Atelectasis pulm. Entcritis acuta.


•"">«;. 'ámský Václ.	11 d.	I), Sepsis.	Pneumonia lobul. lobor. infer. Pneumo-malacia lobi sup. part. sup. lobi sup. sin. Knteritis acuta. Icterus levis.


57. Doskočil Ant.	<; n.	D. c.	Atelectasis pulm. lobor. infer. Enteritis catarrh. chron. intestini crassi.


58. Jedlička Josef	i1/, m.	D. Tuberculosis.	Vitium cordis con^cnitum. Dcfectus septo mcmbranaceo ventricul. Ductus Piotalli pers. Hypertr. myocardi dc-xtri. Atelect. pulm. partialis. Entcritis chron. Venostasis.


5í). Kohoutek Emanuel	On.	IX c.	Tuberculosis pulmonum subacuta. Dis-s< minatio nodosa lymphadc-nitideca-seosa ^landular. peribronehialium peritrachealium. Tubere. ^landul. me-sent< Tumor lienis. Enteritis follicu-laris.


			'


﻿Jméno	Vek	Diagnosa klinická	Poznání pitevní


Ilcjduk Vilém	12 d.	D. c.	Atclcctasis pulm. partialis. Gastrocn-teritis acuta.


íll. Schurcr Adolf	5 n.	1). c.	Lcptomeningitis cerebrospinalis. Tumor lienis.


<;•_>. Chlastáková Al/bčta	lid.	1). c.	lleitis catarrhalis. Necroses circumscri-ptae multiplices ventriculi post erro-siones haemorrfaagicas. Atr. univ.


<;;>. Zelenková Otilie	lli d.	I). c.	Omphalitia purulcnta. Pncumonia lo-bularis bilateralis. Pleuritis sicca láteř. sin. Peritonitis íibrino-purulenta. Tumor lienis. Sepsis. plcuropncum. exsud. bac. ohromném množství. exsud. pcriton. strcptococcus bacillus coli.)


Cl. Rohlík Josef	Ji n.	D. Kntcritis ač.	Pncumonia lobul. láteř, dcxtri. Stomato-mykosis. Entcritis follicularis.


<;r>. Lanzin^cr Rudolf	l.r> d.	D. Pncumonia. Omphalitis purul.	Scpsis post omphalitidcm purulcntam. Entcritis acuta. Tumor lienis follicularis.


(><>. íloncová Maric	18 d.	D. c.	Sepsis post omphalitidem purul. Hac-morrhagiac intermening. Pncumonia lobul. Entcritis.


<!7. Kovářík Josef	14 d.	D. Entcritis ač.	Omphalitis purulcnta. Atclcctascs in-sularcs pulm. Enteritis catarrh. acuta.


(íS. Soukupová Anna	14 d.	D. Tctcrus gravis.	Omphalitis purulcnta. Pncumonia lobul. bilateralis. Peritonitis suppurativa dif-fusa. Ictcrus.


'')!'. Růžičková Maric	Bn.	D. (Mater luc-tica.)	Pncumonia lobul. lobi sup. dcx. Enteritis acuta. Haemoglobinaemia.


70. Hamtáková Antonie	14 d.	D. Parotitis sup.	Parotitis suppurativa lat. dcxtri. Scpsis. Atrophia univcrsalis.


71. Kcllcr Vilém	Bn.	D. c.	Entcritis acuta. Haemorrha^iae intcr-meningcalcs.


1-. llíibner Gust.	1 n.	D. Atclcctasis pulm.	; Pncumonia lobul. conťluens bilateralis praec. lobor. infer.


7:». Lažánck Jaroslav	1 d.	í). (Infans prac-matur.) Vitium cor-dis.	Atclcctascs pulmonum partis poster. \'cnostasis. Haemorrha^iae cpicarcli.


			


﻿10


Jméno	Vek	Diagnosa klinická	Poznání pitevní


74. Zdichyncc Karel	""2 m.	D. c.	Atelcctas. pulm. Enteritis chronica. Tumor licnis.


75. Hcld Josct	5n.	D. c.	Tuberculosis miliaris pulmonum, hc-patis, lienis. Caseiticatio glandularum peribronchialium. Atelectasis pulmon. partialis. Enteritis acuta. Angioma hc-patis. Ocdema scroti.


7(>. Šuhrt Frant.	íin.	D. Atrophia gastroenteritide.	Pneumonia lobul. contluens lobor. inf. Enteritis acuta. Atrophia cxcessiva.


77. Škvára Ant.	lt> d.	D. Pncumonia.	Tracheobronchitis catarrh. diffusa. Atc-lectases insulares pulm. Catarrhus in-tcstinor. acutus.


78. Abrahamova Josefa	13 d.	D. c.	Atelect. pulm. Atrophia univ.


79. Slavík Josef	1 m.	D. Gangracna extrém, inf. dextr.	Phlegmone extrcmitatis inf. dex. prac-cipue femoris subsequente gangracna part. mollium. Decubitus multiplices. Pneumonia lobul. Sepsis.


80. Halbigová Marie	1 m.	D. Trismus. Ec-lampsia.	Encephalitis acuta. Hacmorrhagiac in-tcrrneningeales. Tumor lienis. Pneumonia lobul. Degeneratio parench. orga-norum.


81. Kotka Frant.	lid.	D. Omphalitis gangracnosa.	Sepsis omphalitide gangracnosa. Soor pharyngis oesophagi. Haema-toma sul)duralc intcrmeningeale. Hydrocephalus internus. Pneumonia lobularis cum haemorrh. punctiformi-bus pleurae. Tumor licnis. Degeneratio adiposa hcpatis renum.


82. Nováková Marie	10 d.	IX c.	Pneumonia lobularis lobor. infcr. Hae-morrhagiac pleurae. Tumor lienis. Degeneratio parenchymatosa organorum. Sepsis.


83. Pelika Viktor	17 d.	D. c.	Atclcct. pulm. Atrophia univers.


81. Kollinger Jos.	19 d.	D. Morbus Win-kelii.	Pncumonia lobularis. Degeneratio adiposa hepatis renum. Icterus. (Buhl.)


85. Strach Václav	17 d.	D. c.	Atelectasis part. poster, lobor. super. Entcritis acuta. Pneumonia lobularis lobor. infcr.


8fi. Kabát Alois	1 m.	D. Cephalhacma-toma. Icterus scp-ticus.	Cephalhacmatoma ossis parictalis impressio. Icterus. Tumor lienis. Degeneratio adiposa organorum. Atelec-tascs insulares pulmonum.


			


﻿11


Jméno	Vek	Diagnosa klinická	Poznání pitevní


87. Zbíralová Maric	10 d.	D. Ictcrum neo-natorum.	Entcritis acuta. Ocdcma pulmonum. Icterus.


88. Zdichyncc Fr.	10 d.	D. Ilacmophilia.	Pncumonia lobularis. Entcritis. Anae-mia.


S!». Hradecký Antonín	ÍW d.	D. c.	Scpsis omphalitidc purul. Synchon-drosis partialis suturarum cranii. Hy-poplasia ccrcbri microgyria lobor. parictalium. Hydroccphalus intcrnus chronicus. Ependymitis granulosa. Ab-sccssus lol)i inf. pulm. sin. Entcritis acuta tcnuis crassi. Tumor licnis. Dcgcncratio adiposa hcpatis renum.


!M. Procházková Anna	5 d.	D. Cheilognatho-palatoschisis.	Cheilognathopalatoschisis. Pncumonia lobul. conrtucns latcris utriusque. Ocdcma ligamentiarycpiglottici latcr. utriusque. Emphysema pulm. part. antcr. Colitis follicularis.


1)1. Kučera Josef	25 d.	D. Entcritis.	Pncumonia lobul. dispcrsa lobor. infcr. Entcritis chron. prače, intcst. crassi. Rachitis incipiens.


í»-J. Pctruška Fr.	10 d.	D. c.	Pncumonia lobul. Gastrocntcritis. Atro-phia.


93. Dolcjška Josef	'27 d.	D. Enter. chron.	Pncumonia lobular. lobor. infer. Entcritis. Atrophia.


91. Králová Anna	B4 d.	D. Pncumonia.	Pneumonia lobul. Entcritis chron. In-tumesccntia gld. mescntcrii.


95. Vávra Rudolf	Im.	D. Lucs.	Entcritis catarrh. chron. crassi. Tumor lienis. Hyperacmia pulmonum.


9(5. Grafová Anna	•lij d.	D. Eclampsia. Pncumonia. Ente-ritis.	Pneum. lobul. Entcritis. Tumor lienis.


97. Vittmannová Anna	Im.	D. Pneum. lobul. Entcritis catarrh.	Lues hcrcditaria. Gummata miliaria multiplicia hcpatis. Soor linguac pharyngis oesophagi palati mollis. Pneumonia lobularis. Colitis catarrh.


98. Synccký Fr.	18 d.	D. Pncum. lobul.	Bronchitis bronchiolitis acuta sub-scquentc bronchopncumonia lobi


99. Kolonátů Barbora	Ba.	D. Entcritis.	Pncumonia lobularis. Entcritis.


100. Jungvvirthová Maric	'A m.	D. Enter. chron.	Colitis catarrhalis. Pneumonia lobul. Tumor licnis.


			


﻿12


Jméno	Vek	Diagnosa klinická	Poznání


101. Štolpová Marie	7S d.	D. c.	Tuberculosis caseosa ""landul. lymph. pcribronchial. Perforatio vénám pul-monal. Disseminatio miliaris univers.


102. Matějková Eliška	11 n.	D. Pneumonia.	Pneumonia lobularis lobor. inferiorum. Knteritis catarrh. chron.


10a 'hladko Kateřina	25 d.	D. c.	Pneumonia lobul. lobor. infer. Enteritis.


101. Kudláček Josef	1 d.	D. Haemophilia (Lues matris).	Lues hereditaria. Hepatitis pericellu-laris. Haemorrhagiae testus cellul. pcri-trachealis. Enteritis.


105. Simáček Fr.	21 d.	D. c.	Pneumonia lobularis bilateralis. Enteritis.


106. Keková AI.	í3 m.	D. c.	Pneumonia lobul. bilatcr. Enteritis. Tumor lienis.


107. Kouba Karel	o n.	D. c.	Pneumonia lobul. Enteritis. Icterus.


108. Kříž Karel	l m.	D. Enter. chron.	Pneumonia lobul. contluens lobor. inf. Enteritis. De«eneratio parench. hepatis re-


100. Tatrman Vojtech	<; d.	D. Icterus (jravis.	Catarrhus duodeni acutus. Tumor lienis. Icterus mechanicus.


110. Hruška Fr.	Bd.	D. c.	Pneumonia lobul. lobor. super. Atelcc-tasis lobor. inf. Catarrhus duodeni. Dc-gcneratio parenchymatosa hepatis renum. Icterus.


111. Kondrášová Markéta	<; d.	D.c. Atclcct. pulm. Idiotismus.	Mikrocephalia. Atelectasis pulmonum. Icterus. Enteritis acuta.


112. Marek Alois	1 týd.	D.c. Atelect. pulm. lyperaem. cerebri.	Atelectas. pulm. Vcnostasis.


113. Kvasničková Anna	lid.	1). c.	Pneumonia lobul. pulm. utriusque. Catarrhus intest. tenuis.


114. Dráb Josef	10 d.	I). c.	Lues congenita. Pneumonia lobul. bi-lateral. Tumor lienis. Exanthema cutis papulosum.


11""). Vodičková Antonie	10 d.	D. Enterocatar.	Pneumonia lobul. bilateralis. Gastro-entcritis acuta. Atrophia universalis.


110. Jiranová Marie	7 n.	D. Enterocatar. chron. Otitis med. suppur. Bronchitis.	Pneumonia lobul. bilateralis. Catarrhus intest. chron. Haemorrhagiae cutaneae.


			


﻿Jméno	Vek	Diagnosa klinická	Poznání pitevní


117. Horáčková Anna	25 d.	D. Pneum. lohul. Knteritis chron. Omphal. ulcerosa.	Sepsis omphalitide purulenta. Pneu-j monia. Enteritis. Fibromyoma jejuni.


118. Vajncrová Maric	LSd.	D. Enterocatar. ač. Bronchopneum.	Sepsis omphalitide purulenta. Pneu-monia lobul. Catarrhus intest. acutus.


lil). Hrnčířová Anna	2 m.	D. Enterocatar. chron.	Enteritis chron. Atrophia universalis.


120. Pilousova Kateřina	5 n.	I). Atelert. part. pulm. Enteritis.	Pleuritis seroíibrinosa Pneum. lobul. conlluens lobor. infer. Enteritis catarrh. chron. Rachitis.


1:21. Zierhutová Ludmila	od.	D. c.	Bronchopneum. bilatcralis. Haematoma durae re<^. occipit. pariet. Hae-morrhagiae intermenin^eales cercbri. Icterus.


122. Kyselka Fr.	2 m.	D. c.	Bronchopncumonia láteř. dex. Entcro-catarrh. chron. Atrophia.


1213. Čapek Ant.	17 d.	D. Enter. Phle^-mone cruris anti-brachii sin. Omphal.	Sepsis omphalovasculitidc purulenta phle<ímone antibrachii sin. re-jnonis mallei int. extrém, inf. sin. Pneu-monia. Enteritis. Tumor lienis.


124. Schiiffncrová Karolina	12 d.	D. Atelcct. pulm.	Pncumonia lobul. bilateralis. Enteritis acuta.


125. Kopecký Václav	10 d.	I). Gan^racna ^in^ivae maxillae super.	Bronchopneum. lat. sin. Gangracna gin-^ivae maxillae sup. Colitis acuta. Gan-gracna palpebrae sup. bát. dextri.


12<>. Resl Alois	IHd.	D. Atclect.pulm.	Pneumonia lobularis bilateralis.


127. Lukeš Ant.	>	D. c.	Pleuropncumonia dcxtrolateralis.


128. Dušek Frant.	Id.	1). Atelect. pulm. Icterus.	Bronchopneum. lobul. lobor. infer.


129. Konvalinková Marie	2 d.	n. c.	Atelcctasis pulm. Vcnostasis. Gastro-enteritis acuta.


130. Uhlířová Anna	8d	I), c.	Hacmorrhagia ccrebri rcjrionc thal. optici capsul. internac nuclei lenti-formis ventriculi lateralis hcmisphae-rae sin. Hacmorrha^ia intermeningc-alis basim. Atelectasis pulmonum. Gastromalacia.


131. Kilián Frant.	(Id.	D. c.	Atelectasis pulm. Venostasis.


			


﻿14


Jméno	Vek	l Diagnosa klinická	Poznání pitevní


132. Veselá Anna	i»d.	IX Enteritis.	Pneumonia lobor. inf. Gastroenteritis acuta.


133. Šulc Bohumil	Id.	D. c.	Lues congenita. Pneumonia alba. Hepatitis pericellularis. Icterus.


131. Krasová Josefa	3d.	D. c.	Bronchopneumonia conlluens loborum infer. Aspiratio sanguinis post epistasin. Haemorrhagiac1 intermeningeales epi-cardi, mucosae intestini crassi rc-num.


135. Kantova Lco-poldina	2 h.	D. c.	Atelectasis pulm. paene totalis. Veno-stasis. Hypoplasia univ.


13(í. Mráz Jan	8d.	D. Kclampsia.	Bronchopneumonia lobii sin. Haemorrh. intcrmeningcales praec. hemisphaerae sin. ventricul. láteř. dex. Haemor-rhagiae gland. suprarenalium. Keratitis ulcer. dex.


137. Horová Bož.	7'/2h.	D. (Luesr)	Atelectasis pulm. lobor. infer. Hyper-aemia lobor. super.


138. Jelínek Jaroslav	3d.	D. Atclect. pulm.	Atelect. pulm. Venostasis universalis. Haemorrh. punctif. pleurae. Dilatatio ventriculorum cordis.


139. Mullerová Anežka	8h.	D. c.	Apneumatosis pulm. pacne totalis. Hy-perplasia gl.thymi thyreoideae. Hae-morrhagiae punctiíbrmes pleurae. Venostasis organorum.


110. Máchová Olga	12 d.	I), Omphalitis purul. Enteritis.	Atelectas. pulm. bronchopneumonia dispersa pulm. utriusque. Omphalova-sculitis purulenta. Enteritis catarrhalis. Venostasis.


141. Jelínek Josef	12 h.	I), c.	Atelectasis pulm. Venostasis. Atrophia.


142. Macke Frant.	2d.	I). c.	Atelectas. pulm. Venostasis. Haemor-rhagiae intermeningeales.


143. rondová Anežka	Ih.	I). c.	Atelectas. pulm. loborum inf. part. poster, lobor. super. Venostasis hepatis licnis. Hacmorrhagiae intermenin-gcalcs.


			


﻿Přehled komplikací vrozené clabosti případech l—143.


Debilitas congenita prostá			Gastro-cnte-ritis	Pneu-monia	Sepsis Pnctl-pneumoin- moniQ testinalis nuril-Fischl .		Om-phalitis	Gan-graena cutis	Phleg-mone	Lucs	Tuber-culosis	Icterus neona-torum	Degene-ratio adip. orga-norum	Vzácnější komplikace


bez	b) atel-	Včk												


atelektas.	ektasí	V CK			icnid									1


—	Č. 4	18 d.	č. 13,	č. 8,	č. 5,	č. 7,	č. 4,	Č.3	č. 79,	č. 10,	č. 59,	č. 44,	č. 46,	Porencephalia (6)


—	11	I3,<m.	15,22,	20,27,	19, 25,	29,30	16, 33,		123	97, 104,	75, 101	45, 52	84,76	Microcephalia (111)


—	12	8d.	23, 26,	31, 47,	34, 39,		36,38,			114, 133				Kongenitalní anomá-


—	18	Id.	32, 35,	50, 51,	48, 49,		63, 65,							lie urogenitalního systému (37)


—	21	5d.	41,44,	72, 82,	66,64,		66, 67,							Haemorrhagia cere-


—	24	9d.	55, 57,	98, 99,	69, 76,		(18, 81,							bri (18, 130)


__	28	lid.	ÍJO M	121. 126,	77 85,		89, 117,							Hyperplasia thymi


—	42	10 d.	71, 74,	127, 128,	88,91,		118, 140							thyseoideae (Í39) (Asthma thymicum)


—	43	Im.	87, 90,	134, 136	92, 9;i,									Vitium cordis en-


—	73	Id.	95, 109,		94, 96,									docarditide footali


—	78	13 d.	1 19, 129		100, 102,									(58)


	83	1 d.			103, 105,									Meningitis cerebro-


														spinalis (17, 61)


__	112	7 d.			106, 107,									


														Erysipelas (40)


__	131	6 d.			108, 110,									


														Parotitis suppurativa


—	135	2h.			113, 115, 'i									(70)


—	137	7y.li.			116,120,									Encephalitis acuta


—	138	3d.			122, 124,									(80)


	139	8h.			132									Gingivitis gangrae-


														nosa subsequente


—	141	12 h.												sepsi (125)


—	142	2d.												


—	143 Ih.									1				


Úhrn	21 př.	;	21 př.	18 př.	34 př.	3př.	16 př.	Ipř.	2př.	5 př.	a př.	o př.	3 př.	13 případů


﻿Ifi


Snažíce zužitkovati fakta přehledu vyplývající, nalézáme, nebylo mezi řadou četných autopsií prosté debilitas congcnita ani jediného případu, kde atclckíasa plic nebývala konstatována. Jak podrobných protokolů pitevních jsme seznali, šlo většinou atelektasu plic značnou; rovněž smrt většinou, jak přehledu patrno, nastala bud1 několik hodin porodu, nebo průběhu několika dní; pouze dva případy ukazují věk vícencdělní. Autoři připouštějí, atclektasa plic může potrvati více neděl beze změny; sem tedy náležely ony dva případy, ačkoliv možno jest též, takových případů někdy již bronchopneumonie etablovala partiích atelektatickýcll, což makroskopicky velmi nesnadno rozpoznati. Vůbec zdá se, jsou právě ložiska atelektatická místy zvláště pracdisponovanými pro usídlení zánětlivých změn plících, tím jejich význam pro děti debilní ještě jest značnější. našich 14'> případech konstatována byla 5Gkrátc; tedy o(J%.


řadě komplikací vrozené slabosti ovšem gastrocnferitis místo prvé, našich případech nalezena byla TUkráte, tedy 4'.)0/,,. Sledujeme tento process chorobný kojenců stránce anatomické již více let, musíme dle výsledků vlastních pozorování souhlasiti názorem Fischlovým,1) totiž neběží onemocnění zažívadel, nýbrž pravou sepsi, jelikož původ nemoci veliké části případů záleží pravé infekci mikrobielní traktem zažívacím, orgánech pak ostatních nalezeny bývají degencrativné nekrotické processy, jakož často podaří vypěstovati mikroby pathogenní značné virulence nejen střev, ale jiných orgánů krve. Není zde místa, abychom podrobněji této věci šířili, odkazujeme práci Fischlovu, jakož stať Czerny-Moserovu, jichž pozorování jen můžeme potvrditi. Některé případu našich jsou význačným typem sepse pneumo-intestinal-ními příznaky, jako př. případ K), kde nalezeny byly mnohonásobné tečkovité výlevy kůži, případ 134., kde tečkovité výlevy rozsety byly orgánech vnitřních, jsouce indikátorem značné intensity pochodu septického. přehledu patrno, veliká část případů gastroenteiitidy vystupuje současně pneumonií (.'M- případů), jen menší část (21 případů) jest nekomplikovaná. Stojí tudíž affekcc pneumo-intestionalní septická popředí všech koni] likací vrozené slabosti, možno směle říci, jest právě kontingent dětí debil-ních, němž toto onemocnění své domovské právo.


Vedle gastroenteritidy důstojně řadí pncuinunic, jež často, jak výše ukázáno bylo, prvější chorobou sdružuje. našich případech konstatována byla 1-Skráte jako samostatné onemocnění, 4f)kráte sdružení jinými chorobami, summou u'3kráte, tedy 4.'Vf>°/„. Většinou byla bromliopncnmonic kalarrlialní, jen několika případech stupňoval zánět hnisáni, jak ukazují tři případy pneumonie vytvořením hlíz. ani pneumobacillus FW., infekce řídkým jest zjevem dětí, neušetří dětí debilních, ukázalo několik případů těžké pleuro-pncwnonic fibrinosni.


Fischl Ueber septische Infektion děs Siiuglings mit gastrointestinalcn Symptomen. Zeitschrift Heilkunde XV.


﻿17


Infekce pupku konstatována byla pouze 1(> případech, l!'#*%,. Buď šlo infekci thrombu tepnách (omphaiarteritis septica), neb infekci míznic kol cév pupečních. Pouze dva případy měly zápětí peritonitidu hnisavou (streptokokky), jeden sdružen byl pleuritidou hnisavou, asi metasta-tickou, jen jediný případ byl rázu gangraenosftfho. Ostatní případy byly takového druhu, vyžadovaly diagnose jen nejpečlivějšího vyšetření makroskopického, často mikroskop napomáhati musel. Jaký markantní ro/díl dob nynějších předantiseptických, nichž omphalitis septická byla zjevem všedním nalezincích porodnicích, často provázená neobyčejně těžkými komplikacemi následnými, jako gangraena okolí pupku, phlegmonosni in-tiltráty stěny břišní, septilopyaemie atd.


PhUgmona ukázala pouze dvou případech. jednom nich (č. !:L).) šlo asi pochod metastatický při omphalovaskulitidě, nebot vyskytla phle<^-inone současně ruce noze.


třech případech mimo značnou atrofii povšechnou ikterus nebylo nalezeno jiných změn pathologických. Ikterus novorozených^ jak známo, pozorován bývá velmi často prvních dnech porodu, zejména dětí vrozenou slabostí. Jest celku zjevem benigním, jenž obyčejně brzy vymizí při náležitém ošetření dítěte; někdy však trvá delší dobu, nabývá značné intensity případ končí lethalně. ikuru novorozených ovšem přesně rozeznávati jest ikterus septický ikterus mechanický, jenž vznikl katarrhu cluodena ťývodů žlučových, neb foetalní okkluse vývodů. původu vlastního ikteru novorozených, jak známo, podány byly dvě theorie: Výklad Birch-Hirsch-fcldm< ikterus ten hepatogenní, vznikající stísněním žlučovodů oedema-tosním vazivem interstitielním. Oedem autor vyvozuje venostasy. Druhá theorie, jež neméně přívrženců, než první, pokládá ikteius haematogenni vidí vznik barviva ikterického rozpadu krvenek rudých. Dokázáno totiž, novorozenců post partům rozpadá určitý počet tělisek rudých, čímž počet jich, bezprostředně porodu zvýšený, vrací normám. Dějc-li rozpad tento míře rozsáhlejší více dní, pak prý vzniká ikterus novorozených. Ilofiiuucr Silbermann nalezli dětí stížených ikterem krvi veliké množství stínu rudých krvenek moči značné percento urátu močoviny. Zjev ten vysvětlovali značnějším rozpadem bílkovin těla cirkulujících, částečně rozpadem krver.ek rudých. Jsou toho přesvědčení, značnější kvanta uvolněného jsou velmi zhoubnými pro normální krvenky nule. Jejich pokusy zvířatech skutečně ukázaly tento neblahý vliv těliska krevní. Zdá se, dětí vrozeně slabých při ikteru jde též stupňovaný rozpad krvenek rudých nad meze fysiologické nesoucí, mající následek. postupně haemoglobin nových nových krvenek rudých uvolňuje zhoubné změny zápětí. Tím asi dal vysvětliti exitus při ikteru novorozených, zejména dětí debilních.


třech případech konstatován při pitvě obraz nejvíce odpovídající ne-


7ur Haematoloiíie děs Neugebor. Kinderheilkunde. XXVI.


prav ,áiik IV. Třiila II. ﻿18


moci Ikihlově, totiž tuková degenerace org.inu. Hlava pojednávaje nemoci Huhlově vykládá tukovou degeneraci orgánu výsledek působení neznámého agens parasitarního, poukazuji1 vztah emoci jednak cnteri-tidám, jednak kryptogenním sepsím vleklejším. našich případech také šlo děti několikanedélní (11\ 2O, ;>1 dní). Takové případy při přesnějším vyšetření bakteriologickém objeví býti sepsemi, jak vícekráte našem ústavu dokázati mohlo. našich případech asi šlo též sepsis; aspoň tomu zdá nasvědčovati nález nádoru sleziny případě jednom, značná pneu-monie lobularní případe druhém. Vyšetření bakteriologické nebylo vykonáno.


vzácnějších komplikací dalších jmenujeme leptomeningitis ccrcbrospi-nalis, leptomeningitis současnými abscessy trče (septikopyacmier crysipel) parotitis hnisavou, akutní enccpJialitis, gingwiíis gangraenosni druhotnou sepsí.


Velmi zajímavý dále jsou dva případy krváceni <f<> mozku. případě prvém (č. l-S plících nalezena rozsáhlá, téměř úplná atelektasa plic, postranní komory mozkové částečně ventrikl střední naplněny byly sražc-ninou krevní svěží, tvořící přesný odlitek komor, hlavně rohů. Pleteň venosní těla choroidea maximum krví naplněna. Aetiologie krvácení tomto případu nebyla sice najisto postavena, ale soudě zkušeností analogických případech dospělých, šlo thrombosu venae magnae Galeni, se-kundrrní stasu vénách mozkových, hlavně ovšem choroidalních; krvácení asi povstalo následkem ruptury některé překrvené venulae plexus cho-roidei. kostech lebečných známky nějakého úrazu tom případu nalezeny nebyly. případě druhém roztříštěna byla tkáň mozková typickou haemor-rhagií krajině kolena zadního ramene vnitřního pouzdra okolí polokouli levé, krev vedrala levé postranné komory, tuto vyplnila, načež roztříštěn byl strop komory nastal výlev rozsáhlý intermeningcalní nad parit-talním, týlním temporalním lalokem strany levé. Aetiologie tomto případu jest nejasnou, jelikož histologické vyšetření nebylo provedeno. kostech lebečných nebylo úrazu, splavy venosní průchodné neporušené, největší pak roztříštění tkáně shledává typickém místě caps int. okolí. Zdá se, zde příčinou krvácení bylo prasknutí aneurysmatu miliarního, jak b>'\á většině případů haemorrhagie mozku dětí.


Stopujíce dále řadu zjevu athologických při vrozené slabosti nalézáme některé stavy chorobné, které ukazují, již foetu působil nepříznivý vliv zabraňující vývoj organismu, čímž stalo se, některé orgány bud zcela, neb částečně nedostatečně vytvořily. Uvádíme případ portnccphalie ič. ti), týkající laloku čelního polokoule levé, kde celá zadní polovina závitu čelního středního částečné okolních přiléhajících závitkův jen rudimen-terně vyvinula, zůstala hluboko vkleslou pod niveau závitúv okolních. Tím vznikla hluboká zapadlina cín zdélí cín zšíří, níž pia arach-noides sestupovaly.


Viz učebnici 17-J.


﻿19


Uvádíme dále případ inikroccpluilic. kde šev frontální okcipitalní částečně sagittalní nahrazeny byly chrustavkovou tkaní spojující dotyčné kosti jevící hypoplasii patrnou. Rovněž mozek velikosti členřní byl rudimcnterně jen vyvinut. Sem náleží také případ atresic vagíny ure-t/ii-<t/)ií, kydrmupkrasou vrozenou obojstrannou rozdělením dělohy pochvy dvé podélným septem.


Případ foetalni endokarditidy následovní srdeční vadou ukazuje, probíhají někdy choroby určitějšího rá/u. Tím ovsem, nepřímo, dotýkánu1 aeliologii: vrozené slabosti. Zdá se, příčina debility vrozené jest mnohonásobnou, velmi rozmanitou, něco určitého souborném sestavení nebyli jsme nalézti literatuře.


Jest nepopíratelno, celé řadě případu momentem vážným jest dč-diěnost. Znánu-, dědí nejen podoba vnější rodičů, ale některé an<- -malie vývoje. Připomínáme příklad hermaphrodismus. anomálie- de-formity získané stávají dědičnými, opakují-li řadě descendentů, jak anthropologie experimentální pathologie řadu případu možno uvésti. Ale nejen tolik, ale chorobné stavy konstitutionelní dědí se; tak dědí potomci tuberkulosních onu pověstnou praedisposici tuberkulose, neb nemoc samu; rodičů luetických dítě hned foetu přejímá onu význačnou im-munitu, neb častěji lues samu. Tyto dvě choroby jsou dvojími závažnýiri příčinami vrozené slabosti. Zejména tuberkulosa matky zápětí debilnost •novorozeného dítěte. Známo dále všeobecně, potomstva phthisikú zůstává zhusta stav organismu, který prese příznivé podmínky životní stane době puberty známého habitu phthisického. mezi dětmi luetických rodičů, donesených správně, když nezdědily chorobu samu, zvykli jsme vídati individua jevící všechny známky vrozené slabosti sníženi resistence vitální. Které nich vydrží, zůstávají často slabými, atrofickými, dospělém věku infantilními. Značný počet mezi nimi jeví malformace vrozené, neb nedokonalý vývin intclligence, hypoplasii jednotlivých orgánů infantilní varlata. hypoplasie uteru, maním (Fournier)]. Možno často postihnouti známky ka-chcxie, jež zajisté zdroj jizvě vlivu škodliviny luetické foetus prvního rýhování vajíčka úplného vývinu dítěte. takových individuí musíme představiti, škodlivina alterovala smyslu nepříznivém postupně vyvíjející série buněčné neprospěch rozvoje organismu, čímž utvářeny byly vlastnosti vitální buněk, které suir.mou vyjádřily pak jako debilnost organismu. určité škodliviny infekční, toxiny bakterielní takovýto vliv el< -•Jienty organismu mají, svědčí dlouhá dnes řada experimentu laborau řích bakteriologických provedená. Známo, injekcemi opětovanými čistých toxir.u mikrobů pathogenních různých možno zvířete způsobiti kachexii. Ale nejen t"", ale rozvoj cmbnonalní možno toxiny působiti. Znám příčině jest pokus Alafucciho, JIMIŽ způsobil kachexii kuřete tím, vpravil bílku vejce líhnutí připraveného kultury bacillu tuberkulosy lidské. toho vyplývá, škodlivina působící při toetalním rozvoji organismu, když nezavedla charakteristické pro processy pathologické, může působiti neprospěch organismu vyvíjejících, všeobecně zadržujíc evoluci vzrůstu snižujíc.


.>* ﻿•JO


energii vitální buněk. Tím nepříznivěji ovšem utváří poměry, zdědí-li choroba sama. našich případech nalezli jsme pět dětí debilních, nichž autopsie konstatovala herediterní lues, ,""> případy tuberkulosy; ovšem nesnadno jest rozhodnouti, zda vznikla post partům infekcí dítěte matky jest-li dědičnou. Všechny tři dítky totiž byly vícenedělní, infekce post paitum jest pravdě podobnější.


výkladu předcházejících ovšem snadno jest pochopitelné, proč přichází vrozená slabost dítek rodičů stížených chronickými chorobami konstitutio-nelními jinými než tuberkulosa lues (alkoholismus jiné různé chron. otravy, arnaemie perniciosní, zhoubné nádory atd.). rodičů jinak normálních, ale excessivně slabých vyžilých děti debilní vzcházejí, jest přirozeno. Ovšem jiných příčin, řekli bychom více lokalisovaných, vrozená slabost v/nik svíi] bére; jsou to, jak známo, choroby placenty pupečníku, které znesnadňují omezují vývoj plodku.


Konečně nepopiratelné jest faktum, jsou hlavně dítky nemanželské, které tvoří většinu dítek vrozené slabých. hledali nutno příčinu nepříznivých poměrech matky době těhotenství. Zde vliv zřejmý mají dlouhotrvající psychické stavy depressivní, stupňující někdy melancholii anebo zoufalství, bída. anebo druhé straně manipulace směřující za-t.ijení těhotenství, jako zúmyslné hladovění, stahování nemírné korsetem, nebo používání různých jedovatých látek účelem vyhnání plodu.


Cifra úmrtí dětí vrozeně slabých tvoří značné peicento úmrtí dětí vůbec. ústavu prof. Hlavy doneseno bylo konce lcS*)4 celkem í>78 dětí nalezince :V>ii dětí porodí,.ce (nečítaje mrtvě porozené), summou l.YU mrtvolek. těch připadá děti vrozeně slabé ;*4í', tedy 22'7íV'/... Srovnali jsme přehledu níže uvedeném věk oněch .'54(,' dětí debilních. Tn-belia tato ovšem jen cenu relativní, rovněž jako cifry výše uvedené, jelikož část dětí debilních, jakmile zotaví, dána jest ošetřování venek. Úmrtí dětí těch jest nesnadno kontrolovati, číslice nebyly nám přístupny, r-»vnéž diagnosou jsou potíže, jelikož dozor nad nalezineckými dětmi svěřen jest úřadu farnímu, lékař obyčejně ultimis vidí, neb vystavuje jen lístek úmrtní, obyčejně diagnosou debilitas congenita. Ale přece, uvá-ž;rr.e-li, dítky slabé obyčejně zadržány bývají celý měsíc ústavu pro eventuelní pozdější objevení lues herediterní, musíme představiti, asi rifry pro první neděle čtyry jsou správné vidíme, úmrtnost prvního dne skoro vyrovná úmrtnosti celého následujícího téhodne, načež druhý týden něco klesne; klesání úmrtnosti ovšem .'i. týden jest velmi značné. XrjvétM úmrtnost tudíž jeví prvního druhého dne porodu následujících dnech. (Viz tabulku násl. str.)


Pokládali jsme povinnost sděliti souboru výsledky tak četných autopsií dětí vrozeně slabých, jelikož, pokud literatuře bylo nám možno poohlédnouti se, dosud tak nestalo.


Panu prof. Hlavovi dík projeviti materiál rady interess, jakým skromnou tuto práci sledoval, pokládám milou svoji povinnost.


﻿Přehled věku dětí stížených vrozenou slabostí, donesených ústavu pathologicko-anatomického


října 1883 prosince 1894.


den													1 n							'2. týden	H. týden	l. týden	2. měsíc J	ii. měsíc	Další


-									x i-H i—l -—l		.C T-H	1-2—24 h.	T5 -M	TD CO	•o -t	-o »o	•o	""O i-	•o X						


M	* •?i	.C	JC Tf	.C iíí	X	i~	j= •f.	x																	


B	12	1	B	1	7	6	\\	1	B	;	k2	: ;\l «	»	14	11	• 1:1	1'2	12	1 L5	1 T;Í dčtí	liH děti	•24 dčtí	: •20 détí	| dčtí	1 ditč


					B	1																			


					HH dčtí 100 dčtí																				


																	('ihrnc-m íilíi dCtí								


																				1					


﻿*"
